Rank	Nation	Gold	Silver	Bronze	Total
1	France	14	7	7	28
2	Italy	12	8	10	30
3	Slovenia	5	4	3	12
4	Spain	4	14	6	24
5	Greece	3	4	9	16
6	Tunisia	3	0	0	3
7	Algeria	2	0	2	4
8	Croatia	0	3	3	6
9	Egypt	0	1	2	3
Total	Total	43	41	42	126
